1111111111111
1C0A110001C01
1000000001111
1P00111E00001
1111111111111
