1111111111111
1C0A110001E01
1000000001111
1000111P00001
1111111111111
