1111111111111
1C0A110000C01
1000000111A01
1P00111E00001
1111111111111
