1111111111111
1C0A1100P1001
1000000001111
100E111P00001
1111111111111
