111111111111
100000000001
100000000001
100011100001
1P0C1E100001
111111111111