1111111111111
1C0A110001P01
1000000001111
1000111E00001
1111111111111
